#########################################
# A                   #     # # #     # #
##### # # # # ######### ### # # # ##### #
#     # # # #         #   # #   # #     #
### ##### # # # # ##### ##### # # # ### #
# # #     # # # # #   # #   # #       # #
# # ##### # # ### # ### # ### ##### # ###
#   #     # #   #                 # #   #
# ##### # ####### # # # ########### #####
# # #   #     # # # # #     #   #   #   #
# # # # # # ### # # ### # ##### ####### #
#   # # # # #     #   # # #         #   #
# # ##### ##### ####### ### ######### ###
# # #         # # #             #   #   #
# ### # ### ### # ### # ### # ### ### ###
# #   # #   #   # # # #   # # # #       #
# ### # # # ### # # # # ### ### # ##### #
# #   # # # #       # # #             # #
# ####### # ### ### # # # # # # ### #####
#  #     #   #   # # # # # # # #      B #
#########################################
